"state","city","violent.crime","burglary","total.population","male.population","female.population","ratio","crime.per.capita"
"Maine","Bangor",76,253,33039,15919,17120,0.481824510427071,0.00230031175277702
"Illinois","Decatur",352,921,76122,35642,40480,0.468222064580542,0.0046241559601692
"Pennsylvania","Berwick",25,148,10477,5000,5477,0.477235849957049,0.00238617924978524
"Pennsylvania","Scranton",252,641,76089,36647,39442,0.481633350418589,0.00331191105153176
"Illinois","Rock Island",222,217,39018,18717,20301,0.479701676149469,0.00568968168537598
"Wisconsin","Sheboygan",170,262,49288,24414,24874,0.495333549748417,0.00344911540334361
"Connecticut","Norwich",99,274,40493,19597,20896,0.483960190650236,0.00244486701405181
"Illinois","Moline",176,204,43483,21018,22465,0.483361313616816,0.00404755881608905
"Pennsylvania","Wilkes-Barre",172,271,41498,20281,21217,0.488722348064967,0.00414477806159333
"Connecticut","New London",366,183,27620,13644,13976,0.493989862418537,0.0132512671976828
"Rhode Island ","Providence",1133,1929,178042,85802,92240,0.481919996405343,0.00636366699992137
"Illinois","Danville",328,659,33027,16526,16501,0.500378478214794,0.00993126835619342
"Wisconsin","Janesville",179,339,63575,31102,32473,0.489217459693276,0.00281557215886748
"New Jersey","Bridgeton",322,484,25349,14576,10773,0.575012821018581,0.0127026707167936
"Connecticut","New Haven",1870,1451,129779,62508,67271,0.481649573505729,0.0144091108730997
"Ohio","Canton",729,1590,73007,34591,38416,0.473803881819552,0.00998534387113565
"Ohio","Massillon",66,353,32149,15579,16570,0.484587389965473,0.00205294099349902
"Alabama","Oxford",62,179,17197,8269,8928,0.480839681339769,0.00360527999069605
"Pennsylvania","Altoona",163,226,46320,22239,24081,0.480116580310881,0.00351899827288428
"Pennsylvania","Erie",458,1095,101786,49126,52660,0.482640048729688,0.00449963649224844
"Pennsylvania","Gettysburg",27,24,7620,3670,3950,0.481627296587927,0.00354330708661417
"West Virginia","Vienna",13,19,10749,5053,5696,0.470090240952647,0.00120941482928645
"Missouri","Saint Louis",5661,4986,319294,154171,165123,0.482849662066935,0.0177297412416143
"Maine","Lewiston",80,328,36592,17590,19002,0.480706165282029,0.00218627022299956
"Ohio","Lima",466,618,38771,20481,18290,0.528255654999871,0.0120192927703696
"West Virginia","Parkersburg",146,433,31492,14965,16527,0.475200050806554,0.00463609805664931
"Michigan","Warren",715,999,134056,64884,69172,0.484006683773945,0.00533359193173002
"New Jersey","Ocean City",15,88,11701,5499,6202,0.469959832492949,0.00128194171438339
"Indiana","Gary",728,1634,80294,36926,43368,0.459884922908312,0.00906667995117942
"Michigan","Monroe",108,234,20733,9753,10980,0.470409492114021,0.00520908696281291
"Indiana","La Porte",28,188,22053,10640,11413,0.482474039813177,0.00126966852582415
"Indiana","South Bend",622,1744,101168,48982,52186,0.484164953344931,0.00614818915071959
"Indiana","Michigan City",120,325,31479,16182,15297,0.514056990374535,0.00381206518631469
"Maine","Auburn",47,179,23055,11136,11919,0.483018867924528,0.00203860333983951
"Indiana","Mishawaka",160,501,48252,22703,25549,0.470508994445826,0.00331592472850866
"North Carolina","Lenoir",51,231,18228,8674,9554,0.475861312266842,0.00279789335088874
"Alabama","Anniston",504,912,23106,10649,12457,0.460875962953345,0.0218125162295508
"Illinois","Peoria",919,1420,115007,54763,60244,0.476171015677307,0.00799081795021173
"Wisconsin","Racine",374,1101,78860,38465,40395,0.487763124524474,0.00474258179051484
"Ohio","Cincinnati",2887,5483,296943,142672,154271,0.480469315659908,0.00972240463658008
"Michigan","East Lansing",116,215,48579,23574,25005,0.485271413573766,0.00238786306840404
"Illinois","Kankakee",237,348,27537,13475,14062,0.489341613102371,0.00860660202636453
"New York","Binghamton",315,558,47376,23218,24158,0.490079365079365,0.00664893617021277
"Alabama","Gadsden",372,835,36856,17489,19367,0.474522465812893,0.0100933362274799
"Massachusetts","Pittsfield",191,372,44737,21472,23265,0.47996065896238,0.00426939669624695
"Indiana","Muncie",258,690,70085,33306,36779,0.475222943568524,0.00368124420346722
"New York","Niagara Falls",619,750,50193,23946,26247,0.477078477078477,0.0123323969477816
"Maine","Portland",173,411,66194,32306,33888,0.488050276460102,0.00261352992718373
"New York","Utica",411,591,62235,29924,32311,0.480822688197959,0.00660400096408773
"Illinois","Champaign",741,722,81055,41256,39799,0.508987724384677,0.00914194065757819
"New York","Albany",802,887,97856,47319,50537,0.483557472204055,0.00819571615434925
"Maine","South Portland",49,108,25002,11919,13083,0.47672186225102,0.001959843212543
"Virginia","Hampton",314,758,137436,65750,71686,0.47840449372799,0.00228469978753747
"Michigan","Lansing",1078,1307,114297,55332,58965,0.484107194414552,0.00943156863259753
"Connecticut","Hartford",1655,1050,124775,60260,64515,0.48294930875576,0.0132638749749549
"West Virginia","Beckley",189,335,17614,8201,9413,0.465595548995118,0.0107301010559782
"New York","Rome",46,133,33725,17324,16401,0.513684210526316,0.0013639733135656
"Ohio","Akron",1759,3429,199110,96257,102853,0.483436291497162,0.00883431269147707
"Indiana","Kokomo",177,462,45468,21286,24182,0.468153426585731,0.00389284771707575
"Illinois","Rockford",2083,2224,152871,73867,79004,0.483198252121069,0.0136258675615388
"Maryland","Cumberland",166,317,20859,9808,11051,0.47020470779999,0.00795819550314013
"New Jersey","Hammonton",15,60,14791,7360,7431,0.49759989182611,0.00101413021431952
"Ohio","Toledo",3352,6729,287208,138973,148235,0.483875797331551,0.0116709840951506
"New Jersey","Atlantic City",699,481,39558,19396,20162,0.490318014055311,0.0176702563324738
"New Jersey","Camden",1993,1089,77344,37626,39718,0.486476003309888,0.0257679975175838
"New York","Buffalo",3382,3976,261310,125208,136102,0.479155026596762,0.012942482109372
"Ohio","Dayton",1384,3043,141527,68951,72576,0.487193256410438,0.00977905276025069
"New Hampshire","Manchester",624,849,109565,54356,55209,0.496107333546297,0.0056952493953361
"New Hampshire","Nashua",204,375,86494,42661,43833,0.493224963581289,0.00235854510139432
"Illinois","Evanston",228,421,74486,35490,38996,0.47646537604382,0.0030609779018876
"Pennsylvania","Harrisburg",727,613,49528,23828,25700,0.481101599095461,0.0146785656598288
"West Virginia","Wheeling",245,265,28486,13368,15118,0.469283156638349,0.00860071614126237
"Ohio","Springfield",373,1420,60608,28865,31743,0.476257259767687,0.00615430306230201
"Michigan","Saginaw",1211,1042,51508,24264,27244,0.471072454764308,0.023510910926458
"Wisconsin","Waukesha",107,233,70718,34656,36062,0.490059108006448,0.00151305183970135
"Rhode Island","Warwick",102,334,82672,39544,43128,0.478323979098123,0.00123379136829882
"Illinois","Chicago",NA,22748,2695598,1308072,1387526,0.485262268335264,NA
"New Jersey","Trenton",1251,1291,84913,43790,41123,0.51570430911639,0.0147327264376479
"Illinois","Des Plaines",65,137,58364,28423,29941,0.486995408128298,0.00111370022616682
"Illinois","Skokie",134,284,64784,30732,34052,0.474376389231909,0.00206841195356878
"Illinois","Arlington Heights",41,140,75101,36019,39082,0.479607461951239,0.000545931478941692
"Illinois","Schaumburg",68,199,74227,35840,38387,0.482843170274967,0.000916108693602058
"Virginia","Newport News",754,1029,180719,87263,93456,0.482865664373973,0.00417222317520571
"Connecticut","Middletown",72,156,47648,23140,24508,0.485644728005373,0.00151108126259234
"Alabama","Birmingham",3237,4704,212237,99337,112900,0.468047512921875,0.0152518175435951
"Ohio","Warren",279,812,41557,19982,21575,0.480833553913901,0.00671367038044132
"Illinois","Hoffman Estates",66,129,51895,25572,26323,0.492764235475479,0.00127179882454957
"New York","Kingston",70,114,23893,11492,12401,0.480977692211108,0.00292972837232662
"Iowa","Ames",78,291,58965,31247,27718,0.529924531501738,0.00132281862121598
"New York","Troy",335,593,50129,25328,24801,0.505256438388957,0.00668275848311357
"New York","Syracuse",1372,1896,145170,69180,75990,0.476544740648894,0.00945098849624578
"Wisconsin","Wausau",120,241,39106,19211,19895,0.49125453894543,0.00306858282616478
"Pennsylvania","Reading",828,1447,88082,42757,45325,0.485422674326196,0.00940033150927545
"Pennsylvania","Bethlehem",238,377,74982,36032,38950,0.480541996745886,0.00317409511616121
"Pennsylvania","York",587,433,43718,21054,22664,0.481586531863306,0.0134269637220367
"Michigan","Bay City",215,199,34932,17019,17913,0.48720371006527,0.00615481506927745
"Pennsylvania","Hanover",31,30,15289,7325,7964,0.479102622800706,0.00202760154359343
"New York","Elmira",104,250,29200,14772,14428,0.505890410958904,0.00356164383561644
"Indiana","Terre Haute",191,1035,60785,31392,29393,0.516443201447726,0.00314222258780949
"Ohio","Youngstown",684,1739,66982,32970,34012,0.492221790928906,0.0102116986653131
"New Jersey","Newark",3220,2144,277140,137116,140024,0.494753554160352,0.0116186764812008
"Louisiana","Houma",210,281,33727,16547,17180,0.49061582708216,0.00622646544311679
"Illinois","Bloomington",372,357,76610,37280,39330,0.486620545620676,0.00485576295522778
"Wisconsin","Oshkosh",191,340,66083,33836,32247,0.512022759257298,0.00289030461692114
"Minnesota","Duluth",NA,642,86265,42243,44022,0.489688749782646,NA
"New York","Rochester",2069,2978,210565,101707,108858,0.483019495167763,0.0098259444827013
"Pennsylvania","Williamsport",111,266,29381,15009,14372,0.510840338994588,0.00377795173751744
"Wisconsin","Fond du Lac",183,118,43021,20502,22519,0.476557960066014,0.00425373654726761
"Illinois","Urbana",148,416,41250,20668,20582,0.501042424242424,0.00358787878787879
"Illinois","Naperville",119,255,141853,68981,72872,0.486285097953515,0.000838896604231141
"Wisconsin","Neenah",35,76,25501,12463,13038,0.48872593231638,0.00137249519626681
"Ohio","Mansfield",178,1016,47821,25323,22498,0.529537232596558,0.00372221409004412
"Iowa","Cedar Falls",47,104,39260,18903,20357,0.481482424859908,0.00119714722363729
"Missouri","Saint Joseph",323,993,76780,38242,38538,0.498072414691326,0.00420682469393071
"Michigan","Southfield",352,625,71739,32068,39671,0.447009297592662,0.00490667558789501
"Michigan","Kalamazoo",657,835,74262,36646,37616,0.493469068972018,0.00884705502141068
"Michigan","Farmington Hills",74,231,79740,37565,42175,0.471093554050665,0.000928016052169551
"Michigan","Novi",37,72,55224,26712,28512,0.483702737940026,0.000669998551354484
"Michigan","Troy",60,181,80980,39883,41097,0.492504322054828,0.000740923684860459
"Pennsylvania","Lebanon",99,123,25477,12327,13150,0.483848176786906,0.00388585783255485
"Maryland","Baltimore",8789,7770,620961,292249,328712,0.470639863050981,0.0141538679562807
"Georgia","Rome",190,490,36303,17285,19018,0.476131449191527,0.00523372724017299
"New York","Glens Falls",43,51,14700,7135,7565,0.485374149659864,0.00292517006802721
"Iowa","Sioux City",274,621,82678,40640,42038,0.491545513921478,0.00331406178185249
"Iowa","Waterloo",470,828,68406,33138,35268,0.48443119024647,0.00687074233254393
"New York","Schenectady",626,810,66135,31991,34144,0.483722688440311,0.00946548726090572
"Illinois","Springfield",1138,1670,116250,54825,61425,0.471612903225806,0.00978924731182796
"Wisconsin","West Allis",191,552,60411,29577,30834,0.489596265580772,0.00316167585373525
"Wisconsin","Milwaukee",7759,6977,594833,286949,307884,0.482402623929742,0.0130439972227499
"Iowa ","Council Bluffs",744,970,62230,30282,31948,0.486614173228346,0.0119556484010927
"Virginia","Roanoke",542,940,97032,46390,50642,0.47808970236623,0.00558578613240993
"Missouri","Jefferson City",261,235,43079,22074,21005,0.512407437498549,0.00605863645859932
"Michigan","Flint",2774,2979,102434,49140,53294,0.479723529296913,0.0270808520608392
"Tennessee","Jackson",972,972,65211,30149,35062,0.462329975004217,0.014905460735152
"Michigan","Portage",76,184,46292,22191,24101,0.479370085543938,0.00164175235461851
"Massachusetts","Barnstable",283,378,45193,21780,23413,0.481933042727856,0.00626203173057774
"Kentucky","Owensboro",125,469,57265,26989,30276,0.471300096044704,0.00218283419191478
"Pennsylvania","Philadelphia",17853,12004,1526006,719813,806193,0.471697358988104,0.0116991676310578
"New Jersey","Vineland",225,694,60724,29167,31557,0.480320795731506,0.00370528950662012
"Alabama","Hoover",86,393,81619,39221,42398,0.480537619916931,0.00105367622734902
"Louisiana","Baton Rouge",2507,3826,229493,110400,119093,0.481060424500965,0.0109240804730428
"North Carolina","Hickory",265,475,40010,19075,20935,0.476755811047238,0.00662334416395901
"Illinois","Elgin",257,357,108188,53888,54300,0.498095907124635,0.00237549450955744
"Texas","Wichita Falls",475,1259,104553,54172,50381,0.518129561083852,0.00454315036393026
"North Carolina","Rocky Mount",749,1046,57477,26296,31181,0.457504741026846,0.0130312994763123
"Missouri","Springfield",1596,2215,159498,77326,82172,0.484808586941529,0.0100063950645149
"Louisiana","Thibodaux",65,74,14566,6709,7857,0.460593162158451,0.00446244679390361
"Missouri","Kansas City",5862,6964,459787,223183,236604,0.485405198494085,0.0127493817789542
"Michigan","Detroit",15011,13488,713777,337679,376098,0.473087532940961,0.0210303778350942
"Pennsylvania","Chambersburg",82,120,20268,9444,10824,0.465956187092954,0.00404578646141701
"Michigan","Ann Arbor",227,714,113934,56155,57779,0.492873066863272,0.00199238155423315
"Michigan","Livonia",146,323,96942,46859,50083,0.483371500484826,0.00150605516700708
"Michigan","Taylor",303,563,63131,30215,32916,0.478607973895551,0.00479954380573728
"Alabama","Decatur",240,821,55599,26745,28854,0.481033831543733,0.00431662439971942
"Massachusetts","Springfield",1606,2317,153060,72573,80487,0.474147393179145,0.0104926172742715
"South Carolina","Sumter",403,599,40524,19071,21453,0.470610008883625,0.00994472411410522
"Michigan","Dearborn",322,462,98153,48519,49634,0.494320092101107,0.00328059254429309
"Michigan","Midland",38,56,41706,20047,21659,0.480674243514123,0.000911139883949552
"Minnesota","North Mankato",NA,28,13394,6609,6785,0.49342989398238,NA
"New Jersey","New Brunswick",382,557,55181,28262,26919,0.512169043692575,0.00692267265906743
"North Carolina","Morganton",52,156,16918,8260,8658,0.488237380305001,0.00307364936753753
"Missouri","Joplin",288,653,50150,24025,26125,0.479062811565304,0.00574277168494516
"Virginia","Norfolk",1332,2261,242803,125797,117006,0.518103153585417,0.0054859289218008
"Wisconsin","La Crosse",154,404,51320,24580,26740,0.478955572876072,0.00300077942322681
"California","Chico",282,778,86187,42706,43481,0.495503962314502,0.0032719551672526
"Washington","Longview",156,468,36648,17632,19016,0.481117659899585,0.00425671250818599
"Virginia","Christiansburg",30,87,21041,10074,10967,0.478779525687943,0.00142578774773062
"Virginia","Blacksburg",39,80,42620,23430,19190,0.549741905208822,0.000915063350539653
"Kansas","Wichita",2869,3919,382368,188523,193845,0.493040735626412,0.00750324294920077
"Kansas","Topeka",772,1277,127473,60941,66532,0.478069865775498,0.00605618444690248
"Oregon","Corvallis",67,235,54462,27403,27059,0.503158165326283,0.00123021556314495
"Pennsylvania","Allentown",653,1248,118032,56869,61163,0.48181001762234,0.0055323979937644
"California","Yuba City",247,501,64925,32121,32804,0.494740084713131,0.00380438968040046
"Virginia","Radford",78,102,16408,7779,8629,0.474098000975134,0.00475377864456363
"Arkansas","Pine Bluff",625,1124,49083,23326,25757,0.47523582503107,0.0127335329951307
"Indiana","Fort Wayne",931,2025,253691,122783,130908,0.48398642442972,0.0036698187953061
"Arizona","Flagstaff",262,242,65870,32518,33352,0.49366934871717,0.00397753150144223
"New Mexico","Santa Fe",331,1907,67947,32180,35767,0.473604426979852,0.00487144391952551
"Virginia","Charlottesville",198,162,43475,20754,22721,0.47737780333525,0.00455434157561817
"Oregon","Eugene",430,1515,156185,76324,79861,0.488676889586068,0.00275314530844831
"New Mexico","Farmington",481,332,45877,22630,23247,0.493275497525993,0.0104845565315954
"Virginia","Staunton",42,62,23746,10747,12999,0.452581487408406,0.00176871894213762
"Florida","Sebring",51,136,10491,5078,5413,0.48403393384806,0.00486130969402345
"Tennessee","Bristol",143,184,26702,12710,13992,0.475994307542506,0.0053554040895813
"Alabama","Dothan",316,874,64609,30574,34035,0.473215805847483,0.00489095946385179
"Minnesota","Mankato",NA,346,39305,19662,19643,0.500241699529322,NA
"Massachusetts","Worcester",1758,2040,181045,88150,92895,0.486895523212461,0.00971029302107211
"Connecticut","Danbury",109,287,80893,39706,41187,0.490845932280914,0.0013474589890349
"California","Redding",705,1088,89861,43492,46369,0.48399194311214,0.00784545019530163
"Connecticut","Bridgeport",1760,1377,144229,69996,74233,0.485311553155052,0.0122028163545473
"New York","White Plains",92,82,56853,27355,29498,0.481153149350078,0.00161820836191582
"Virginia","Portsmouth",461,1218,95535,45933,49602,0.4807976134401,0.00482545663892814
"Connecticut","Stamford",351,290,122643,60402,62241,0.492502629583425,0.00286196521611507
"Connecticut","Norwalk",272,250,85603,41977,43626,0.490368328212796,0.00317745873392288
"Arkansas","Little Rock",2579,4244,193524,92245,101279,0.476659225729109,0.013326512473905
"Arkansas","North Little Rock",449,1204,62304,29457,32847,0.47279468412943,0.00720659989727786
"Louisiana","Monroe",490,1172,48815,22385,26430,0.45856806309536,0.0100378981870327
"Idaho","Lewiston",55,289,31894,15684,16210,0.491753934909387,0.00172446228130683
"Georgia","Albany",813,1408,77434,35723,41711,0.461334814164321,0.0104992638892476
"Mississippi","Jackson",1668,4124,173514,80615,92899,0.464602279931302,0.00961305715965282
"New York","New York",52993,18635,8175133,3882544,4292589,0.474921203116818,0.00648221869907193
"Florida","Melbourne",658,648,76068,36921,39147,0.485368354630068,0.00865015512436241
"Florida","Palm Bay",553,719,103190,49807,53383,0.482672739606551,0.00535904641922667
"Florida","Titusville",294,519,43761,21057,22704,0.481181874271612,0.00671831082470693
"Florida","Daytona Beach",715,799,61005,30490,30515,0.499795098762397,0.0117203507909188
"Pennsylvania","Lancaster",465,439,59322,29468,29854,0.496746569569468,0.00783857590775766
"Missouri","Cape Girardeau",243,500,37941,17982,19959,0.473946390448328,0.00640468095200443
"Florida","Ormond Beach",122,199,38137,17985,20152,0.471589270262475,0.00319899310380995
"Missouri","Saint Charles",101,222,65794,32253,33541,0.490211873423109,0.00153509438550628
"Iowa","Dubuque",128,NA,57637,27910,29727,0.484237555736766,0.00222079566944844
"Louisiana","Shreveport",1550,2425,199311,93354,105957,0.468383581438054,0.00777679104515054
"Maryland","Salisbury",366,336,30343,14043,16300,0.462808555515275,0.0120620901031539
"New Mexico","Albuquerque",4151,6677,545852,265106,280746,0.485673772377861,0.00760462542960363
"South Carolina","Easley",106,224,19961,9441,10520,0.472972295977155,0.00531035519262562
"Arizona","Prescott",168,197,39843,19583,20260,0.491504153803679,0.00421654995858746
"Montana","Missoula",221,378,66788,33332,33456,0.499071689525064,0.0033089776606576
"Florida","Clearwater",727,919,107685,52044,55641,0.483298509541719,0.00675117240098435
"Florida","Saint Petersburg",2239,2933,244769,117704,127065,0.480877888948355,0.00914740020182294
"Montana","Great Falls",151,320,58505,28580,29925,0.488505255961029,0.00258097598495855
"Florida","Largo",394,574,77648,36661,40987,0.472143519472491,0.00507418091901916
"Arkansas","Fort Smith",687,1064,86209,41996,44213,0.487141713742185,0.00796900555626443
"Oregon","Medford",425,477,74907,36270,38637,0.484200408506548,0.00567370205721762
"West Virginia","Martinsburg",89,127,17227,8408,8819,0.488071051256748,0.00516630870145702
"Iowa","Davenport",604,890,99685,48558,51127,0.487114410392737,0.00605908612128204
"Minnesota","Eagan",NA,181,64206,31543,32663,0.491278073700277,NA
"Indiana","Lafayette",407,713,67140,32696,34444,0.486982424784033,0.0060619600834078
"California","Hanford",309,337,53967,26469,27498,0.490466396130969,0.00572572127411196
"Louisiana","Alexandria",815,974,47723,22401,25322,0.469396307859942,0.0170777193386837
"Indiana","Bloomington",243,622,80405,40423,39982,0.502742366768236,0.00302220011193334
"Maryland","Hagerstown",197,310,39662,18762,20900,0.473047249256215,0.00496697090413998
"Washington","Spokane",1369,3827,208916,101853,107063,0.487530873652568,0.00655287292500335
"Alabama","Montgomery",827,3409,205764,96687,109077,0.469892692599289,0.00401916759005463
"California","Santa Cruz",433,527,59946,30047,29899,0.501234444333233,0.00722316751743236
"Mississippi","Hattiesburg",118,375,45989,21786,24203,0.473721976994499,0.00256583095957729
"Colorado","Grand Junction",252,308,58566,28958,29608,0.49445070518731,0.00430283782399344
"Georgia","Macon",583,1828,91351,42156,49195,0.461472780812471,0.00638197720878808
"Georgia","Dalton",88,229,33128,16333,16795,0.4930270466071,0.00265636319729534
"Tennessee","Memphis",11507,12575,646889,307019,339870,0.47460847224176,0.017788214052179
"Iowa","Cedar Rapids",356,966,126326,62065,64261,0.491308202586958,0.00281810553646914
"Tennessee","Morristown",203,191,29137,13951,15186,0.478807015135395,0.00696708652229124
"California","Los Angeles",18547,16388,3792621,1889064,1903557,0.498089316069283,0.00489028563623942
"California","Pasadena",433,891,137122,66854,70268,0.487551231749829,0.00315777191114482
"California","Santa Monica",395,586,89736,43284,46452,0.482348221449585,0.00440180083801373
"California","Arcadia",57,339,56364,26889,29475,0.477059825420481,0.00101128379816904
"California","Long Beach",2705,3799,462257,226520,235737,0.490030437613708,0.00585172317563606
"California","Santa Barbara",363,558,88410,43874,44536,0.496256079629001,0.00410587037665422
"California","Gardena",287,297,58829,28292,30537,0.480919274507471,0.00487854629519455
"California","Carson",520,601,91714,43922,47792,0.478901803432409,0.00566979959439126
"California","Torrance",190,529,145438,70732,74706,0.48633782092713,0.00130639860284107
"California","Glendale",233,516,191719,91387,100332,0.476671587062315,0.00121532033862059
"California","Monterey Park",75,249,60269,28907,31362,0.479632978811661,0.00124442084653802
"California","Santa Maria",690,712,99553,50321,49232,0.505469448434502,0.006930981487248
"California","Burbank",243,383,103340,49971,53369,0.483559125217728,0.00235146119605187
"Alabama","Tuscaloosa",478,1182,90468,43512,46956,0.480965645311049,0.00528363620285626
"Louisiana","Hammond",332,993,20019,9243,10776,0.461711374194515,0.0165842449672811
"Idaho","Pocatello",141,262,54255,27061,27194,0.498774306515529,0.00259883881669892
"Kentucky","Bowling Green",189,547,58067,28026,30041,0.482649353333219,0.00325486076428953
"South Carolina","Florence",328,566,37056,16863,20193,0.455068005181347,0.00885146804835924
"California","Watsonville",252,265,51199,25499,25700,0.498037071036544,0.00492197113224868
"Minnesota","Rochester",NA,495,106769,51700,55069,0.484222948608679,NA
"California","Fairfield",454,676,105321,51851,53470,0.492313973471577,0.0043106313080962
"California","Vallejo",878,2688,115942,56277,59665,0.485389246347312,0.00757275189318797
"Florida","Punta Gorda",11,49,16641,7899,8742,0.474670993329728,0.000661017967670212
"Texas","Beaumont",1242,1828,118296,57603,60693,0.486939541489146,0.0104990870359099
"Indiana","Columbus",83,262,44061,21340,22721,0.484328544517828,0.00188375207099249
"Texas","Port Arthur",344,854,53818,26489,27329,0.492195919580809,0.00639191348619421
"California","Modesto",1590,2571,201165,97989,103176,0.487107598240251,0.00790395943628365
"Florida","Ocala",375,606,56315,26800,29515,0.475894521885821,0.00665897185474563
"Massachusetts","Cambridge",431,502,105162,51109,54053,0.48600254844906,0.00409843859949411
"Georgia","Athens-Clarke County",455,1149,115452,54781,60671,0.474491563593528,0.0039410317707792
"Delaware","Wilmington",1228,1212,70851,33661,37190,0.47509562320927,0.0173321477466797
"Texas ","Texarkana",392,616,36411,17296,19115,0.475021284776579,0.0107659773145478
"Kansas","Lawrence",370,604,87643,44000,43643,0.502036671496868,0.00422167201031457
"Virginia","Richmond",1348,2030,204214,97331,106883,0.476612768958054,0.00660091864416739
"Oregon","Salem",564,1043,154637,77115,77522,0.498684014821809,0.00364725130466835
"Oklahoma","Tulsa",3949,6235,391906,190944,200962,0.487218873913643,0.0100763958704383
"Massachusetts","Waltham",146,191,60632,30204,30428,0.498152790605621,0.00240796938910146
"California","Santa Rosa",636,725,167815,81846,85969,0.487715639245598,0.00378988767392665
"South Carolina","Spartanburg",537,479,37013,16336,20677,0.441358441628617,0.0145084159619593
"California","San Luis Obispo",119,414,45119,23538,21581,0.521687094128859,0.00263746980207895
"Massachusetts","Newton",76,185,85146,39843,45303,0.467937425128603,0.000892584501914359
"North Carolina","Goldsboro",312,584,36437,17654,18783,0.48450750610643,0.00856272470291188
"Wisconsin","Madison",897,1601,233209,114832,118377,0.492399521459292,0.00384633526150363
"Louisiana","Lafayette",779,1330,120623,58564,62059,0.485512713164156,0.00645813816602141
"California","Paso Robles",91,152,29793,14508,15285,0.486960024166751,0.0030544087537341
"Arizona","Kingman",93,406,28068,13728,14340,0.489097905087644,0.0033133817870885
"Arizona","Lake Havasu City",58,256,52527,25954,26573,0.494107792183068,0.00110419403354465
"California","San Francisco",5777,5317,805235,408462,396773,0.507258129614336,0.00717430315373773
"Pennsylvania","Bloomsburg Town",20,51,14855,6714,8141,0.451969033995288,0.001346348030966
"Tennessee","Knoxville",1774,2882,178874,85946,92928,0.480483468810448,0.00991759562597135
"North Dakota","Grand Forks",146,228,52838,27057,25781,0.512074643249177,0.00276316287520345
"Tennessee","Cleveland",371,398,41285,19656,21629,0.476105122926002,0.00898631464212184
"Florida","Pensacola",473,711,51923,24617,27306,0.474105887564278,0.00910964312539722
"Florida","Panama City",285,434,36484,17900,18584,0.490626027847824,0.00781164346014691
"Texas","Sherman",139,372,38521,18403,20118,0.477739414864619,0.00360842138054568
"Wisconsin","Green Bay",514,659,104057,51359,52698,0.493566026312502,0.00493960041131303
"Iowa","Des Moines",1094,2514,203433,99535,103898,0.489276567715169,0.00537769191822369
"California","Ventura",310,778,106433,52592,53841,0.494132458917817,0.00291263048114776
"Texas","Denison",94,251,22682,10716,11966,0.472445110660436,0.00414425535667049
"California","Thousand Oaks",157,278,126683,61989,64694,0.489323745096027,0.00123931387794732
"California","Oxnard",603,848,197899,100389,97510,0.50727391245029,0.00304700882773536
"Minnesota","Saint Paul",2101,3150,285068,139355,145713,0.488848274797592,0.0073701713275429
"Oklahoma","Lawton",920,1560,96867,50311,46556,0.51938224575965,0.00949755850805744
"California","San Rafael",191,360,57713,28814,28899,0.499263597456379,0.00330947966662624
"Missouri","Columbia",476,784,108500,52458,56042,0.483483870967742,0.00438709677419355
"Alabama","Huntsville",1696,2165,180105,87530,92575,0.485994281113795,0.00941672913022959
"Iowa","Iowa City",185,387,67862,33755,34107,0.497406501429371,0.00272612065662668
"California","Camarillo",61,139,65201,31535,33666,0.483658226100827,0.000935568472876183
"Georgia","Brunswick",220,294,15383,7267,8116,0.472404602483261,0.0143015016576741
"Minnesota","Minneapolis",3872,4782,382578,192421,190157,0.502958873746007,0.0101208119651417
"Washington","Mount Vernon",79,315,31743,15563,16180,0.490281321866238,0.00248873767444791
"Washington","Anacortes",16,157,15778,7557,8221,0.478958042844467,0.00101407022436304
"New York","Watertown",154,269,27023,12924,14099,0.478259260629834,0.00569884912852015
"Florida","Sanford",323,822,53570,25717,27853,0.480063468359156,0.0060294941198432
"California","Folsom",85,235,72203,38481,33722,0.53295569436173,0.00117723640291955
"Minnesota","Plymouth",NA,258,70576,34175,36401,0.484229766492859,NA
"Minnesota","Bloomington",NA,227,82893,40115,42778,0.483937123761958,NA
"Kentucky","Elizabethtown",37,133,28531,13665,14866,0.478952718096106,0.0012968350215555
"Minnesota","Eden Prairie",NA,107,60797,29468,31329,0.484694968501735,NA
"Pennsylvania","Pittsburgh",2347,2537,305704,148101,157603,0.484458822913668,0.00767736110747651
"Arizona","Douglas",199,92,17378,9503,7875,0.546840833237427,0.0114512602140638
"Montana","Billings",370,793,104170,50266,53904,0.482538158778919,0.00355188633963713
"Massachusetts","Boston",5266,3325,617594,295951,321643,0.479199927460435,0.00852663724064677
"California","Berkeley",487,971,112580,55031,57549,0.488816841357257,0.00432581275537396
"West Virginia","Morgantown",107,175,29660,15859,13801,0.534693189480782,0.00360755225893459
"Kansas","Overland Park",285,517,173372,83735,89637,0.482978797037584,0.00164386406109406
"Washington","Tacoma",1615,2965,198397,97958,100439,0.493747385293124,0.00814024405610972
"California","Redwood City",208,526,76815,38246,38569,0.497897546052203,0.00270780446527371
"Idaho","Idaho Falls",139,276,56813,28141,28672,0.495326773801771,0.00244662313202964
"Florida","Gainesville",851,1009,124354,60212,64142,0.484198337005645,0.00684336651816588
"California","Sacramento",3520,4474,466488,227101,239387,0.486831386873832,0.00754574608564422
"California","South San Francisco",111,351,63632,31435,32197,0.494012446567765,0.00174440533065124
"California","Napa",216,349,76915,37947,38968,0.493362803094325,0.00280829487096145
"Virginia","Virginia Beach",758,1573,437994,214441,223553,0.489598031023256,0.00173061731439243
"Nebraska","Grand Island",162,367,48520,24166,24354,0.498062654575433,0.00333882934872218
"Arizona","Tucson",3851,5021,520116,257312,262804,0.494720408524252,0.00740411754300964
"Washington","Bellingham",220,614,80885,39484,41401,0.488149842368795,0.00271991098473141
"Nebraska","Omaha",2485,3311,408958,201063,207895,0.491647064001682,0.00607641860533356
"Kentucky","Lexington",1066,2854,295803,145591,150212,0.492189058258368,0.00360374979293652
"North Carolina","Winston-Salem",1556,4529,229617,107878,121739,0.469817130264745,0.00677650173985376
"Indiana","Indianapolis",9942,14774,820445,396346,424099,0.483086617628238,0.0121178141130728
"Washington","Everett",481,1165,103019,52392,50627,0.508566380958852,0.00466904163309681
"California","Oakland",7963,6168,390724,189519,201205,0.485045710015254,0.0203801148636889
"Nebraska","Lincoln",1050,1616,258379,129235,129144,0.500176097902693,0.00406379775446147
"California","Hayward",613,1109,144186,71143,73043,0.49341128819719,0.00425145298433967
"California","Madera",466,653,61416,31312,30104,0.509834570795884,0.00758759932265208
"Florida","Tallahassee",1582,2630,181376,85358,96018,0.470613532110092,0.00872221242060692
"Pennsylvania","Carlisle",48,60,18682,8695,9987,0.465421261106948,0.00256931806016486
"California","San Leandro",437,699,84950,40781,44169,0.480058858151854,0.00514420247204238
"New Mexico","Las Cruces",394,991,97618,47535,50083,0.486949128234547,0.00403614087565818
"California","Pleasanton",49,165,70285,34444,35841,0.490061890872875,0.000697161556519883
"North Carolina","New Bern",163,745,29524,13780,15744,0.466738924265005,0.00552093212301856
"North Carolina","Asheville",423,742,83393,39325,44068,0.471562361349274,0.00507236818437998
"California","Fresno",2748,5902,494665,243124,251541,0.491492222008834,0.00555527478192312
"Arkansas","Jonesboro",295,1166,67263,32491,34772,0.483044169900242,0.00438576929366814
"Florida","Jacksonville",5189,7632,821784,398294,423490,0.484669937599174,0.0063143113032135
"Washington","Walla Walla",113,274,31731,16476,15255,0.519239860073745,0.00356118622167596
"Florida","Port Saint Lucie",395,816,164603,80003,84600,0.48603609897754,0.00239971324945475
"Colorado","Pueblo",797,1895,106595,52050,54545,0.488296824428913,0.00747689854120737
"California","Chino",291,562,77983,40071,37912,0.51384276060167,0.00373158252439634
"Nevada","Reno",1192,1633,225221,114494,110727,0.508362896887946,0.00529257928878746
"Virginia","Lynchburg",267,365,75568,35474,40094,0.469431505399111,0.00353324158373915
"South Carolina","Beaufort",139,147,12361,6041,6320,0.488714505298924,0.01124504489928
"California","Bakersfield",1929,4994,347483,170196,177287,0.489796623144154,0.00555135071356009
"North Carolina","Chapel Hill",87,452,57233,26661,30572,0.465832648996208,0.00152010203903342
"Texas","Victoria",405,594,62592,30053,32539,0.480141232106339,0.0064704754601227
"California","San Diego",5529,5902,1307402,660626,646776,0.505296764116928,0.00422899766101016
"North Carolina","Greensboro",1555,3345,269666,126793,142873,0.470185340384031,0.00576639250035229
"California","Orange",135,500,136416,68723,67693,0.503775216983345,0.000989619985925405
"California","Victorville",676,1837,115903,58073,57830,0.501048290380749,0.0058324633529762
"California","Redlands",221,608,68747,32743,36004,0.476282601422608,0.00321468573174102
"Maryland","Frederick",381,245,65239,31475,33764,0.482456812642744,0.00584006499179938
"Texas","Corpus Christi",2057,2452,305215,149656,155559,0.490329767540914,0.00673951149189915
"Texas","Abilene",472,1037,117063,59107,57956,0.504916156257742,0.00403201694813904
"California","San Bernardino",2022,2809,209924,103491,106433,0.492992702120768,0.00963205731598102
"California","Carlsbad",265,497,105328,51485,53843,0.488806395260519,0.00251595017469239
"California","Irvine",110,570,212375,103434,108941,0.487034726309594,0.00051795173631548
"California","Costa Mesa",254,668,109960,55968,53992,0.508985085485631,0.0023099308839578
"Oregon","Portland",3093,4471,583776,289211,294565,0.495414337005975,0.00529826508797895
"California","Ontario",534,1058,163924,81563,82361,0.497565945194114,0.00325760718381689
"California","Santa Ana",1334,1032,324528,165752,158776,0.510747916974806,0.00411058521914904
"California","El Centro",166,734,42598,20719,21879,0.486384337292831,0.00389689656791399
"Arkansas","Fayetteville",388,504,73580,36993,36587,0.50275890187551,0.00527317205762435
"California","Anaheim",1279,1605,336265,167249,169016,0.497372607913402,0.00380354779712429
"Georgia","Marietta",474,496,56579,27691,28888,0.489421870305237,0.0083776666254264
"California","Milpitas",81,332,66790,34136,32654,0.511094475220841,0.00121275640065878
"California","Fountain Valley",106,299,55313,26935,28378,0.486956050114801,0.00191636685770072
"California","Tustin",114,240,75540,36749,38791,0.486483981996293,0.00150913423351867
"California","Newport Beach",101,445,85186,41973,43213,0.492721808747916,0.00118564083300073
"Tennessee","Johnson City",319,540,62785,30225,32560,0.481404794138727,0.00508083140877598
"California","Santa Clara",221,584,116468,58810,57658,0.504945564446887,0.00189751691451729
"Florida","Boca Raton",164,491,84392,41278,43114,0.489122191676936,0.00194331216229026
"Florida","West Palm Beach",821,1289,99919,48629,51290,0.486684214213513,0.00821665549094767
"Alaska","Anchorage",2479,1158,291826,148209,143617,0.5078677019868,0.00849478799010369
"California","Palo Alto",53,327,64403,31490,32913,0.488952377994814,0.000822943030604164
"Florida","Delray Beach",457,565,60522,29127,31395,0.481263011797363,0.00755097319982816
"California","Cupertino",58,175,58302,28771,29531,0.493482213303146,0.000994820074783026
"California","Sunnyvale",170,524,140081,70560,69521,0.503708568613873,0.00121358356950621
"California","Mountain View",155,178,74066,37695,36371,0.508937974239192,0.0020927281073637
"California","Porterville",200,595,54165,26793,27372,0.49465522016062,0.00369242130527093
"Wyoming","Cheyenne",140,255,59466,29330,30136,0.493223018195271,0.00235428648303232
"Delaware","Dover",280,116,36047,16738,19309,0.464338225095015,0.00776763669653508
"California","Stockton",4630,4416,291707,142925,148782,0.489960816847042,0.015872090830868
"California","Visalia",544,1227,124442,60696,63746,0.487745294996866,0.00437151444046222
"California","Merced",810,955,78958,38729,40229,0.490501279161073,0.0102586185060412
"Idaho","Coeur d'Alene",260,431,44137,21454,22683,0.486077440696015,0.00589074925799216
"California","Walnut Creek",84,446,64173,29740,34433,0.463434777866081,0.0013089617128699
"Virginia","Waynesboro",70,88,21006,10006,11000,0.476340093306674,0.00333238122441207
"Florida","Lakeland",465,1296,97422,45687,51735,0.468959783211184,0.00477304920859765
"Washington","Yakima",566,1573,91067,44868,46199,0.492692193659613,0.00621520419032141
"Virginia","Winchester",59,161,26203,12898,13305,0.492233713696905,0.00225165057436171
"Texas","Longview",452,928,78585,38302,40283,0.487395813450404,0.00575173379143602
"Florida","Winter Haven",245,489,33874,15692,18182,0.463246147487749,0.00723268583574423
"Alabama","Auburn",132,418,53380,26736,26644,0.500861745972274,0.00247283626826527
"California","Salinas",1027,1218,150441,76007,74434,0.505227963121755,0.00682659647303594
"Arkansas","Springdale",332,457,69797,34693,35104,0.497055747381693,0.00475665143200997
"Wyoming","Casper",86,363,55316,27517,27799,0.497451008749729,0.00155470388314412
"Arizona","Tempe",878,1250,161719,84200,77519,0.520656199951768,0.005429170351041
"Arizona","Yuma",508,955,93064,47318,45746,0.508445800739276,0.00545860912920141
"Washington","Olympia",150,468,46478,21961,24517,0.472503119755583,0.00322733336202074
"North Carolina","Fayetteville",1186,4109,200564,96976,103588,0.483516483516484,0.00591332442512116
"Iowa","West Des Moines",95,213,56609,27356,29253,0.483244713738098,0.00167817838152944
"Oklahoma","Oklahoma City",5474,9854,579935,285519,294416,0.49232931276781,0.00943898885219895
"North Carolina","Wilmington",618,1694,106476,50857,55619,0.477638153198843,0.00580412487321086
"Utah","Ogden",353,734,82825,42039,40786,0.507564141261696,0.00426199818895261
"Alabama","Opelika",207,428,26477,12566,13911,0.474600596744344,0.00781810628092307
"Oregon","Hillsboro",180,323,91611,45950,45661,0.501577321500693,0.00196482955103645
"North Carolina","Greenville",455,1130,84554,38762,45792,0.458428932989569,0.00538117652624358
"Oregon","Beaverton",141,196,89803,43634,46169,0.485885772190239,0.00157010344865984
"Arizona","Phoenix",9458,17912,1445632,725020,720612,0.501524592704091,0.00654246723924208
"Arizona","Scottsdale",329,1255,217385,104930,112455,0.482691998067944,0.00151344388987281
"Arizona","Mesa",1804,2681,439041,215918,223123,0.491794615992584,0.00410895565562214
"Alaska","Fairbanks",169,130,31535,16791,14744,0.532456001268432,0.00535912478198827
"Washington","Vancouver",592,1044,161791,78884,82907,0.487567293607185,0.00365904160305579
"Idaho","Boise",567,913,205671,101690,103981,0.494430425290877,0.00275683008299663
"Alabama","Fairhope",43,131,15326,7103,8223,0.46346078559311,0.00280568967767193
"Texas","College Station",491,576,93857,47723,46134,0.508465005273981,0.00523136260481371
"South Dakota","Sioux Falls",631,899,153888,76268,77620,0.495607194843003,0.00410038469536286
"Washington","Auburn",248,984,70180,34678,35502,0.494129381590197,0.00353377030493018
"Alabama","Daphne",40,77,21570,10413,11157,0.482753824756606,0.00185442744552619
"Georgia","Gainesville",113,240,33804,16163,17641,0.478138681812803,0.00334279966867826
"Louisiana","Bossier City",236,417,61315,29962,31353,0.488656935497024,0.00384897659626519
"Alabama","Foley",54,87,14618,6853,7765,0.468805582158982,0.00369407579696265
"Colorado","Boulder",249,472,97385,50004,47381,0.513467166401397,0.00255686193972378
"Tennessee","Kingsport",367,431,48205,22354,25851,0.463727829063375,0.00761331812052692
"South Dakota","Rapid City",425,591,67956,33605,34351,0.494511154276296,0.00625404673612337
"Washington","Bellevue",161,685,122363,61330,61033,0.501213602150977,0.00131575721419056
"Washington","Seattle",3746,6523,608660,304030,304630,0.499507113988105,0.00615450333519535
"Connecticut","Milford",46,150,51271,24690,26581,0.48155877591621,0.000897193345165883
"Texas","Waco",635,1550,124805,59740,65065,0.47866672008333,0.00508793718200393
"Arkansas","Conway",252,410,58908,28480,30428,0.483465743192775,0.0042778569973518
"Utah","Clearfield",51,92,30112,15273,14839,0.507206429330499,0.00169367693942614
"Washington","Renton",283,897,90927,44992,45935,0.494814521539257,0.00311238685978862
"Texas","Amarillo",1278,2087,190695,92465,98230,0.484884239230184,0.00670180130575002
"Utah","Logan",32,206,48174,23762,24412,0.49325362228588,0.000664258728774858
"South Carolina","Charleston",296,374,120083,56741,63342,0.472514843899636,0.0024649617348001
"Texas","Killeen",851,1498,127921,62695,65226,0.490107175522393,0.00665254336660908
"Florida","Pompano Beach",1060,1283,99845,50967,48878,0.510461214883069,0.0106164555060344
"Texas","Temple",202,NA,66102,31613,34489,0.478245741429911,0.00305588333182052
"North Carolina","Durham",1710,3284,228330,108556,119774,0.475434677878509,0.00748916042569965
"California","Riverside",1389,2247,303871,150112,153759,0.493999098301582,0.00457101862303412
"Arkansas","Rogers",202,362,55964,27437,28527,0.490261596740762,0.0036094632263598
"Florida","Fort Lauderdale",1543,2951,165521,87387,78134,0.527951136109618,0.00932207997776717
"Arkansas","Bentonville",82,153,35301,17282,18019,0.489561202232231,0.00232288037166086
"Tennessee","Murfreesboro",701,923,108755,53422,55333,0.491214197048412,0.00644568065836053
"Florida","Deerfield Beach",360,594,75018,36221,38797,0.48283078727772,0.00479884827641366
"California","San Jose",3547,5206,945942,475668,470274,0.502851126178984,0.00374970135589708
"Wisconsin","Appleton",213,254,71133,35331,35802,0.496689300324744,0.00299439078908523
"Utah","Salt Lake City",1300,1824,186440,95627,90813,0.51291031967389,0.00697275262819138
"Texas","Tyler",536,1025,96900,45704,51196,0.471661506707946,0.00553147574819401
"South Carolina","Mauldin",48,84,22889,10773,12116,0.470662763772991,0.00209707719865438
"Tennessee","Nashville",7550,5736,601222,291294,309928,0.484503228424775,0.0125577573674949
"South Carolina","North Charleston",737,854,97471,48331,49140,0.495850047706497,0.00756122333822368
"Virginia","Harrisonburg",110,152,48914,22798,26116,0.466083329925993,0.00224884491147729
"California","Temecula",97,588,100097,49002,51095,0.489545141213023,0.000969060011788565
"Georgia","Columbus",994,2709,189885,90870,99015,0.478552808278695,0.00523474734707849
"Indiana","Carmel",11,113,79191,38599,40592,0.487416499349674,0.000138904673510879
"Tennessee","Clarksville",875,976,132929,64768,68161,0.487237547863897,0.00658246131393451
"Colorado","Fort Collins",391,598,143986,71909,72077,0.499416609948189,0.00271554178878502
"Texas","Lubbock",1962,3099,229573,112743,116830,0.491098691919346,0.00854630117653208
"Florida","Fort Myers",754,507,62298,31181,31117,0.500513660149604,0.0121031172750329
"Texas","Bryan",312,496,76201,38255,37946,0.502027532447081,0.00409443445624073
"Florida","Orlando",2508,3778,238300,115883,122417,0.486290390264373,0.0105245488879564
"Florida","Cape Coral",229,860,154305,75364,78941,0.48840931920547,0.0014840737500405
"Florida","Naples",32,96,19537,9019,10518,0.461636894098377,0.00163791779700056
"California","Roseville",293,519,118788,56894,61894,0.478954103108058,0.0024665791157356
"Texas","Brownsville",473,1145,175023,82686,92337,0.472429337858453,0.00270250195688567
"Florida","Marco Island",12,36,16413,8036,8377,0.489611893011637,0.00073112776457686
"Texas","Harlingen",271,606,64849,31005,33844,0.47811068790575,0.00417893876543971
"Texas","Irving",507,1277,216290,108131,108159,0.4999352720884,0.00234407508437746
"Texas","Baytown",247,939,71802,35073,36729,0.488468287791426,0.0034400155984513
"Colorado","Greeley",426,542,92889,45634,47255,0.491274531968263,0.0045861189161257
"Texas","Dallas",8380,16090,1197816,598962,598854,0.50004508204933,0.00699606617376959
"Colorado","Aurora",1433,1791,325078,160099,164979,0.492494109106122,0.00440817280775691
"Texas","Houston",21610,26630,2099451,1053517,1045934,0.501805948316965,0.0102931671184514
"Florida","Miami",4856,4255,399457,198927,200530,0.497993526211833,0.0121565024520787
"Florida","Miami Beach",941,1048,87779,45969,41810,0.523690176465897,0.0107201038972875
"Tennessee","Franklin",93,90,62487,29888,32599,0.478307487957495,0.00148830956839023
"Texas","Arlington",1909,3543,365438,179279,186159,0.490586638499554,0.00522386834428822
"Colorado","Colorado Springs",1968,3641,416427,203944,212483,0.489747302648483,0.0047259183482339
"Georgia","Valdosta",248,655,54518,25563,28955,0.468891008474265,0.00454895630800836
"Texas","Fort Worth",4524,8442,741206,363896,377310,0.49095123353022,0.00610356634997558
"Utah","Provo",149,301,112488,55737,56751,0.495492852570941,0.00132458573358936
"Utah","Saint George",155,307,72897,35654,37243,0.489101060400291,0.00212628777590299
"Texas","San Antonio",6943,15668,1327407,647690,679717,0.487936254667935,0.00523049825712837
"Texas","Laredo",1036,1718,236091,114287,121804,0.484080291074204,0.00438813847202985
"Colorado","Broomfield",30,90,55889,27729,28160,0.496144142854587,0.000536778256902074
"Texas","Midland",398,559,111147,54129,57018,0.487003697805609,0.00358084338758581
"North Dakota","Fargo",394,451,105549,53248,52301,0.504486068082123,0.00373286340941174
"Georgia","Atlanta",6027,6192,420003,208968,211035,0.497539303290691,0.0143498975007321
"Texas","El Paso",2859,1826,649121,311280,337841,0.479540794397347,0.00440441766635188
"Texas","Richardson",171,698,99223,48852,50371,0.49234552472713,0.00172339074609718
"Utah","Orem",41,203,88328,44069,44259,0.498924463363826,0.000464178969296259
"Washington","Kennewick",229,450,73917,36899,37018,0.49919504308887,0.00309806945628205
"Washington","Richland",82,187,48058,23551,24507,0.490053685130467,0.00170627158849723
"Florida","Kissimmee",563,822,59682,29020,30662,0.486243758587179,0.0094333299822392
"Texas","Edinburg",357,857,77100,38332,38768,0.497172503242542,0.00463035019455253
"Virginia","Alexandria",243,281,139966,67262,72704,0.480559564465656,0.00173613591872312
"Georgia","Sandy Springs",187,709,93853,45214,48639,0.481753380286192,0.00199247759794572
"North Carolina","Burlington",406,671,49308,23082,26226,0.468118763689462,0.00823395797842135
"Georgia","Hinesville",153,389,33437,15807,17630,0.472739779286419,0.0045757693572988
"South Carolina","Greenville",509,603,58409,28091,30318,0.480936157099077,0.00871441045044428
"North Carolina","Raleigh",1780,3036,402825,194651,208174,0.483214795506734,0.00441879227952585
"Florida","Tampa",2162,2476,335709,164061,171648,0.488700034851613,0.00644010139734115
"Texas","McAllen",166,503,129877,62044,67833,0.477713528954318,0.00127813238679674
"Washington","Bremerton",230,444,37729,20017,17712,0.530546794243155,0.00609610644331946
"Georgia","Warner Robins",366,781,66224,31663,34561,0.478119714906982,0.00552669726987195
"Texas","Mission",104,423,77058,37052,40006,0.480832619585247,0.00134963274416673
"North Dakota","Bismarck",218,320,61272,29749,31523,0.485523567045306,0.00355790573181878
"Colorado","Denver",3871,5129,600158,300089,300069,0.500016662278933,0.00644996817504724
"Texas","New Braunfels",115,300,57740,27743,29997,0.480481468652581,0.00199168687218566
"Texas","Denton",369,632,113383,55348,58035,0.488150780981276,0.00325445613539949
"District of Columbia","Washington",7448,3519,601723,284222,317501,0.472346910455475,0.012377788450832
"Texas","Sugar Land",109,289,78817,39131,39686,0.496479185962419,0.0013829503787254
"Texas","Plano",358,1095,259841,127078,132763,0.489060617839371,0.00137776563359901
"Texas","Austin",3405,7244,790390,399738,390652,0.505747795392148,0.00430799984817622
"Texas","Odessa",1103,770,98270,48127,50143,0.489742546046606,0.0112241782843187
"Louisiana","New Orleans",2958,3423,343829,166248,177581,0.483519423899671,0.00860311375712927
"Arizona","Sierra Vista",130,246,43888,22334,21554,0.508886255924171,0.00296208530805687
"Texas","Round Rock",141,336,99887,49139,50748,0.491945898865718,0.00141159510246579
"Texas","Conroe",221,447,56207,28383,27824,0.504972690234312,0.00393189460387496
"Pennsylvania","Johnstown",131,285,20978,9816,11162,0.467918772046906,0.0062446372390123
"North Carolina","High Point",556,1188,99053,46539,52514,0.469839378918357,0.0056131565929351
